0010101010101010
0001010101010101
1000101010101010
0100010101010101
1010001010101010
0101000101010101
1010101000101010
0101010100010101
1010101010001010
0101010101000101
1010101010100010
0101010101010001
1010101010101000
0101010101010101
1010101010101010
0101010101010101
