1111100011111111
1000100010001111
1000000000001111
1000100010001111
1111100011110001
1100100011110001
1100000000000001
1111100000000001
1111100011110001
1111100011110001
1111110111111111
1110000000111111
1110000000111111
1110000000111111
1110000000111111
1111111111111111