1010011000110000
1011011110110110
1000000010110110
1011111010110111
0000001010110100
1011101000110110
1011111011110110
1000000000000000
1011101101111011
1011100101111011
1011111101111011
0000000001100000
1011110111101011
1000000000001001
1011011011101111
1011111011100000