1011111111111111
1001000000000001
1001000111111101
1101000100000101
1101111101110101
1100000001010101
1111101111010101
1000101000010101
1000101001110111
1000101001000001
1111101111110111
1100101011000001
1100101011000001
1100101011000001
1111111111000001
1111111111111111